1111111
1200101
1110101
1010101
1000001
1111111