1111111
12*0101
11101*1
1*1*101
10*0*01
1111111