1111111
1000101
1110101
1010101
1000001
1111111